NO ./texture/colorbrick-2-lee.xpm
SO ./texture/colorbrick-9-gun.xpm
WE ./texture/colorbrick-0-gon.xpm
EA ./texture/colorbrick-7-gam.xpm

F 143,188,143
C 135,206,235

1111111111111111111111111111111
1000000000000000000000000000001
1000000000000000000000000000001
1000000000000000000000000000001
1000000000000000000000000000001
1000000000000000000000000000001
1000000000000E00000000000000001
1000000000000000000000000000001
1000000000000000000000000000001
1000000000000000000000000000001
1000000000000000000000000000001
1000000000000000000000000000001
1000000000000000000000000000001
1000000000000000000000000000001
1000000000000000000000000000001
1111111111111111111111111111111
