NO ./texture/colorbrick_0.xpm
SO ./texture/colorbrick_1.xpm
WE ./texture/colorbrick_2.xpm
EA ./texture/colorbrick_3.xpm
DO ./texture/door.xpm
S1 ./texture/goomba_01.xpm
S2 ./texture/goomba_02.xpm

F 143,188,143
C 135,206,235

1111111111111111111111111111111
1000000000000000000000000000001
1000000000000000000000000000001
1000000000000000A00000000000001
1000000000000000000000000000001
10000A0000000000000000000000001
1000000000000E00000000000000001
100000000000000000000A000000001
1000000000000000000000000000001
10000A0000000000000000000000001
1000000000000000000000000000001
100000000000000000A000000000001
1000000000000000000000000000001
1000000000000000000000000000001
1000000000000000000000000000A01
1111111111111111111111111111111


