NO ./texture/colorbrick_0.xpm
SO ./texture/colorbrick_1.xpm
WE ./texture/colorbrick_2.xpm
EA ./texture/colorbrick_3.xpm
DO ./texture/door_0.xpm
SP ./texture/coomba_1.xpm

F 143,188,143
C 135,206,235

        1111111111111111111111111
        1000000000110000000000001
        1011000001110000000000001
        100D000000000000000000001
111111111011000001110000000000001
1000000000110000011101D1111111111
11110111111111011100000010001
1111D111111111011101010010001
11000000110101D11100000010001
10000000D00000001100000010001
10000000100000001101010000001
11000001110101011111011D10N0111
11110111 1110101 101111010001
11111111 1111111 111111111111
